22 22
######################
#.....#........#.....#
#.....#........#.....#
####..#..#..####..#..#
#.....#..#..#.....#..#
#.....#..#..#.....#..#
#..#######..#..####..#
#........#.....#.....#
#........#.....#.....#
#######..#..####..#..#
#..#.....#.....#..#..#
#..#.....#.....#..#..#
#..#..##########..#..#
#..#..#...........#..#
#..#..#...........#..#
#..#..####..#######..#
#..#.....#..#.....#..#
#..#.....#..#.....#..#
#..####..#..#..#..#..#
#...........#..#.....#
#...........#..#.....#
######################
